firstname : Tatia 
mname : 
lastname : Galliher
country : Argentina
state : jujuy
city : vghyjh
website : www.ghty.com
gender : Female
Age: 29
Height: 5' 3"
Weight: 50
Bust: 32"
Waist: 24"
Hips: 33"
Cup: A
Dress: 0
Shoe: 6.0
Hair color: black
Hair Length: medium
Eye Color: Brown
Ethnicity: Asia
Skin Color: white
Shoot nudes: No
Tattoos: None
Piercings: None
Experience:Experienced
Compensation:Depends on Assignment
Genres: FASHION MODEL
about : Good in Acting.
category: south indian
category: bridal